R 1200 1200

NO ./textures/wood.xpm
SO ./textures/wood.xpm
EA ./textures/wood.xpm

WE ./textures/wood.xpm

S ./textures/donuts.xpm
F 034,100, 200
C 125,30,32

11111111111111
10000000000001
10000000000001
10002020000001
10000000000001
10000000000001
10000000000001
10000002000001
10000000000001
10000000000001
100000N0000001
11111111111111