R 1920 1080
NO ./textures/greystone.xpm
SO ./textures/redbrick.xpm
EA ./textures/wood.xpm
WE ./textures/wood.xpm

S ./textures/barrel.xpm
F 255, 200,160
C 255,200, 160
M
                        1111111111111111111111111
                        1000000000000000000000001
                        1000000000000000000000001
                        1000000000000000000000001
1111111111111111111111111000000000000000000000001
1000000000000000000000000000000000000000000000001
1000000000000000000000000000000000000000000000001
1000000000000000000000001111111111110001111111111
1000000000011110000000001          10001
1000000000010000000000001          10001
100000000001000000W000001          10001
1000000000010000000000001          11111
1111111111111111111111111