R 1200 600

NO ./textures/greystone.xpm
SO ./textures/redbrick.xpm
EA ./textures/wood.xpm

WE ./textures/wood.xpm

S ./textures/barrel.xpm
F 034,100, 200
C 125,30,32

111111111111111111111111
1000000000000110000000011111
1000000002000000000000001111
100000000000000000200000011111
10020200000000000000000111
1000020200000001110000001
100000000000001  10000001
111111111111111  10000001
                 100000011111111111111
                 100000000000000000001
        111111111100000000000002000201
        100000000000200000020000000001
        100002000000000000000000000001
        100000000020000000000000000111
11111111100000010000000001000200000001
1000000000000000000000N000001000011001
100000200000100000200NN000000100000001
10002000000010000000000000000000000001
11111111111111111111111111111111111111