R 1200 600

NO ./textures/greystone.xpm
SO ./textures/redbrick.xpm
EA ./textures/wood.xpm

WE ./textures/wood.xpm

S ./textures/barrel.xpm
F 034,100, 200
C 125,30,32

        1111111111111111111111111
        1000000000110000000000001
        1011000001110000002000001
        1001000000000000000000001
111111111011000001110000000000001
100000000011000001110111111111111
11110111111111011100000010001
11110111111111011101010010001
11000000110101011100000010001
10002000000000001100000010001
10000000000000001101010010001
11000001110101011111011110N0111    
11110111 111010101011110100011111
11111111 11111111111111111111