R 1200 600

NO ./textures/greystone.xpm
SO ./textures/redbrick.xpm
EA ./textures/wood.xpm

WE ./textures/wood.xpm

S ./textures/barrel.xpm
F 034,100, 200
C 125,30,32

        1111  111111
        1001  100001
        1001  100001
        100111100001
 1111111100000000001
10000000000111111111
10E022200001
100200000001
111111111111