R 1920 1080

NO ./textures/greystone.xpm
SO ./textures/redbrick.xpm
EA ./textures/wood.xpm
WE ./textures/wood.xpm

S ./textures/barrel.xpm
F 220,100, 200
C 225,30,32

        1111  111111
        1001  100001
        1001  100001
        100111100001
11111111100000000001
10000000000111111111
10E022200001
100200000001
111111111111

1111111111111