C 255,200,160
F 250, 122,   122
R 1200 800     4675     
NO ./textures/wood.xpm
SO ./textures/wood.xpm
EA ./textures/wood.xpm
WE ./textures/wood.xpm
S ./textures/donuts.xpm

        1111111111111111111111111
        1001110000110000000000001
111111111011000001110000002000001
1001000000000111000000001111111111
11111111101101 100111000E000000001
10000000001101 1001110111111111111
11110111111111111100000010001
11110111111111011101010010001
11000000110101011100000010001
10002000000000001100000010001
10000000000000001101010010001
1100000111010101111101111000111
11110111 1110101 101111010001
11111111 1111111 111111111111

