R 1200 600

NO ./textures/wood.xpm
SO ./textures/wood.xpm
EA ./textures/wood.xpm

WE ./textures/wood.xpm

S ./textures/donuts.xpm
F 034,100, 200
C 125,30,32

11111111111111
10000000000001
10000000000001
10000000000001
10000020000001
10000000000001
10000000000001
102000W0000201
10000000000001
10000000000001
10000020000001
11111111111111