R 1920 1080

NO ./textures/greystone.xpm
SO ./textures/redbrick.xpm
EA ./textures/wood.xpm
WE ./textures/wood.xpm

S ./textures/barrel.xpm
F 220,100, 200
C 225,30,32

111111111111
100000000001
10E001000001
100200000001
111111111111