         R 1200 600

NO ./textures/greystone.xpm
SO ./textures/redbrick.xpm
EA ./textures/wood.xpm

WE ./textures/wood.xpm

S ./textures/barrel.xpm
F 034,100, 200
C 125,30,32

11111111111111
10000020000001
10000000000001
10000000000001
120000E0000021
10000000000001
10000000000001
10000020000001
10000000000001
11111111111111